12
1,3,2,6,5,5,7,3,6,7,5,3
2,10,14,9,6,3,8,12,9,10,2,10
10,10,12,1,10,12,5,5,5,9,14,9
10,12,5,5,9,6,5,3,6,5,9,2
12,7,3,6,3,8,0,10,10,4,5,11
6,9,8,10,14,7,3,10,12,5,5,11
14,5,3,12,9,12,9,14,1,6,3,10
12,3,14,5,1,4,3,12,3,10,12,9
4,9,10,6,5,5,13,1,10,12,5,3
6,5,11,10,4,5,3,6,9,6,5,9
14,3,8,12,5,3,10,12,5,9,4,3
8,12,5,5,5,13,13,5,5,5,5,9
